7
8
3 14 10 10 10 10 12 4
4 5 2 10 10 12 7 9
5 7 10 10 12 5 3 12
7 9 2 12 5 3 14 9
7 14 8 5 7 10 3 8
7 9 2 13 7 11 10 8
3 8 2 11 11 10 10 12
